11111111111111111111111111111
100000100000C1100000011100001
1000001000111100000000C000001
100P0010000000X00000011000001
11110011110000000000000000001
10010000X10000111000000000001
10C10000110000000000000000CX1
10010000000000000000000001111
10011111111100111111000001111
10000000010000X00001000001111
100CC0000000X0E00X01000001111
100CC000011111111111000111111
100000000000000000X0000000001
11111111111111111111111111111
