1111111111111111111
1000000000000000001
10100101C0101111001
1010E10111100000001
1011110111101111001
10111101111010C1001
1000000000000000001
10000P0000000C00001
1011110000000000001
1000000000000000001
100CCC0000000000001
1000000000000000001
1111111111111111111
