111111111111111111111111111111111111111
1000000000000000001E1000000000000000001
101001010010111100101001001011110111101
101001C1111011110010100100100011C100101
10111101111C111100101001001C00110100101
101111011110100100101001111011110111101
100000000000000000000000000000000000001
100000000000000000000000000000000000001
100000000000000000000000000000000000001
101111000000000000101001111000000000001
10111100110C010100101001111C11111111101
101001C01100101000101000000000000000001
101001000000010100101001111011110111101
1000000000000000001P1000000000011100001
111111111111111111111111111111111111111
