111111111111111111
111100111111000111
111000111110010011
11001011111PE10011
100110111111110011
100000C11111100111
111110111111001111
111110111100000001
111110111111111101
11111000CCC0000001
111111111111111111
