1111111111111111111
1000000000000000001
101X0101C0101X11001
1010E10111100000001
1011110111101111001
10111101111010C1001
1000000000000000001
10000P0000000C00001
1011110000000000001
1000000000000000001
100CCC000000X000001
10X0000000000000001
1111111111111111111
