1111111111111111111
10000E1111111111111
1111011111111111111
1000PC1111111111111
1111111111111111111
1111111111111111111
1111111111111111111
1111111111111111111
1111111111111111111
1111111111111111111
