1111111111111111111
1000000000000000001
101X0101C0101111001
1010E10111100000001
1011110111101111001
10111101111010C1001
1000000000000000001
10000P0000000C00001
10111100000000X0001
1000000000X00111111
100CCC0000000101001
1000000000000101001
1111111111111111111
